davisPutnam.pri	Theorem
nestedFuns.pri	CounterSatisfiable
InterpoColumnRed.pri	Theorem
Carroll-riddle.pri	GaveUp
ax_diff.pri	Theorem
equiv.pri	Theorem
InterpoPidgeonSimplified.pri	Theorem
equalities.pri	Theorem
InterpoInEqProof2.pri	Theorem
array-triggers.pri	Theorem
equiv2.pri	Theorem
InterpoEqProof5.pri	Theorem
cav-ex4.pri	Theorem
InterpoProp3.pri	Theorem
inEqProof3.pri	Theorem
wolver2.pri	Theorem
inEqProof0.pri	Theorem
InterpoInEqProof.pri	Theorem
functions10.pri	Theorem
InterpoCryptarithm3.pri	Theorem
InterpoErstaunlich.pri	Theorem
InterpoPidgeon.pri	Theorem
lparExample.pri	Theorem
InterpoInEqProof3.pri	Theorem
InterpoEqProof2.pri	Theorem
simple-functions2.pri	Theorem
InterpoProp0.pri	Theorem
bad-predicate-performance.pri	Theorem
infinite-domain-unsoundness2.pri	Theorem
InterpoInEqProof0.pri	Theorem
InterpoEqProof6.pri	Theorem
InterpoProp4.pri	Theorem
pidgeon.pri	Theorem
InterpoPugh.pri	Theorem
tarskiGeometry.pri	Theorem
InterpoEqProof.pri	Theorem
InterpoProp1.pri	Theorem
inEqProof1.pri	Theorem
cav-ex2.pri	Theorem
InterpoPidgeonSuperSimplified.pri	Theorem
infinite-domain-unsoundness3.pri	Theorem
wolver0.pri	Theorem
InterpoProp5.pri	Theorem
clam-004.pri	CounterSatisfiable
pugh.pri	Theorem
group.pri	Theorem
simple-functions.pri	Theorem
probaInt0.pri	Theorem
simple-predicate.pri	Theorem
InterpoProg.pri	Theorem
InterpoQuan.pri	Theorem
InterpoEqProof3.pri	Theorem
InterpoInEqProof1.pri	Theorem
many-equations.pri	CounterSatisfiable
uniExConstants1.pri	GaveUp
InterpoEqProof4.pri	Theorem
ages.pri	CounterSatisfiable
InterpoProp2.pri	Theorem
inEqProof2.pri	Theorem
eqProof.pri	Theorem
wolver1.pri	Theorem
counting.pri	Theorem
InterpoProp0	Theorem
InterpoProp1	Theorem
functions10	Theorem
SET008+3	Theorem
davisPutnam	Theorem
LCL171-1	Unsatisfiable
asdkas	ERROR
error	ERROR
